datefmt=SET DATE AMERICAN
trnrpt=More Transactions {0} More Reports {1} More Procedures {2} More Work Panels {3} More Menus
mmmainmenu=Main menu {0} Data Base Administrator Menu {1} Transactions {2} Reports {3} Create data base {4} Rebuild indices {5} Rebuild redundancy {6} Reorganize data base {7} Export application {8} Use interpreter {0}0 Procedures {0}1 Work Panels {0}2 Menus
mmint=GX Menu Integrator {0} Menus
opt=Options
nomenu=There are no user menus
keys=Esc=Return  F1=Help
prot=Prototype
prod=Production
idx=Reindex data base?
endofproc=End of process
mmmain=GENEXUS - Menu manager
mmmdlname=Model name
mmmdldate=Date created
nooptions=There are no options for this menu
more='More
deleinfo=Do you really want to delete?
sltlst=Selection List
poslst=Type all or part of one of the following fields, then press Enter.
selopt=Select one of the following, then press Enter. {0} More:
lastrec=This is the last matching record
firstrec=This is the first matching record
norectobrow=There is no matching record
filecrea=Creating table {0} {1}.
fileren=Renaming {0} as {1}
dbcrea=Creating data base
conftrn=Confirm transaction?
waschg={0} was changed.
tlotitle=Data transfer to Lotus 1-2-3 (tm)
creaindx=Creating index {0} ...
recconv=records converted
loaddata=Loading data in
nodelete=Unable to delete
inex=No matching {0}
inex_browse=. BROWSE DATA?
queryok=Is query criteria ok?
failequal=Record is not accesible
yes=Y
no=N
date=MM {0} DD {1} YY
conf=Is data ok? (Y/N)
rtop=Send report to printer? (Y/N)
rptques=Send report to
rptsel=Screen SCR;Printer PRN;File FIL
printing=Printing...
canques=Cancel program? (Y/N)
canmsg=Program canceled due to user request
wait=Press Enter key to continue ...
del=Invalid delete, related information in {0}
delcas=Delete all Info for
lock="Record {0} in use by another"
flock="Table {0} in use by another"
help=Help
noupdate=Record already exists
noinsert=Record not found
chg=Discard modifications? (Y/N)
mlmax="Number of lines exceeded
rgzlcktb={0}. Locking tables to reorganize.
rgzdic={0}. Dropping referential integrity constraints.
rgzdropcol=Dropping attributes from table {0}.
1000=Warning: Rename not used. Userid is not '{0}'.
1001=Dropping index {1}, table {0}.
1002=Dropping table {0}.
1003=Setting initial values for attributes in table {0}
1004={0} already exists
dropindx=Droping index {0} ...
outrange={0} out of range
graph=Graph
print=Print
strdate={1} {2}, {0}
runpgm=Running program {0}.
mbactions=Actions
mbview=View
mbhelp=Help
mbview_first=First
mbview_last=Last
mbview_previous=Previous
mbview_next=Next
mbview_select=Select
mbhelp_cont=Contents
mbdelete=Delete
mbrefresh=Refresh
mbclose=Close
mbconfirm=Confirm
selone=Select one of the following. Then press Enter.
selnocor=Selected menu option is not correct.
cmdandopt=Can not select a menu option and specify a command.
cmdlpmpt=Command ===>
deltbl=Dropping old table {0} and creating new one.
rename=Renaming table {0} to {1}
confrpt=Press Enter to start processing.
nochgmode=Cannot change to requested mode.
oneselonly=Cannot select more than one item.
eof=Beginning/End of data reached.
canctrn=Transaction canceled.
confins=Inserting data. Press Enter to confirm.
confupd=Updating data. Press Enter to confirm.
confdel=Deleting data. Press Enter to confirm.
recins=Data was inserted.
recupd=Data was updated.
recdel=Data was deleted.
notsame=Data does not belong to the same {0}.
faildel=Invalid delete. Related info in {0}
noexist=Could not find {0}
noaccept=Changes made to {0} ignored.
failbool={0} must be "Y" or "N".
wrongopt=Option must be "4" or space
dupkey=Data already added by another user.
noprompt=Cursor position is not valid for prompt request.
spc=Specify selection value
tcpe=Type selection criteria, press Enter.
spv=Select an item from list
tope=Type options, press Enter.
oeqs=1=Select
datachg=Data modified by another user ({0}).
icp=Cursor position is not valid.
seloptwrong=Option is not allowed.
nomnuopt=No options for this menu
emptylist=(List is empty.)
callerr=Error calling program {0}
exist=Already existing {0}
norecrpt=There is no data satisfying this report.
0=Enter
enter=Process
cancel=Cancel
display=Display
insert=Insert
update=Update
delete=Delete
first=First
next=Next
previous=Previous
prompt=Prompt
select=Select
menu=Menu bar
exit=Exit
refresh=Refresh
retrieve=Retrieve
morekeys=More keys
badkey=Key is not valid now.
faildate={0} is not a valid date/time.
nohelp=No help available.
lockrcd=Another user locks data of
readerr=Error ( {0} ) processing
usrcanc=Process terminated by user.
tipe=Type information, press Enter.
actions=Actions
view=View
rgzctnt={0}. Create temporary and new tables.
rgzrrpgm={0}. Running reorganization programs.
rgzrnmtbl={0}. Renaming tables.
rgzbldidx={0}. Building indices and integrity constraints.
rgzdroptbl={0}. Dropping removed tables.
rgztbllck=Locking table {0}.
rgzd1c=Dropping integrity constraints on table {0}.
recdeleted=Error - Record was deleted by another user.
keynfound=Data with the specified key could not be found.
unexp=An unexpected error has occurred while updating your data. Please try again.
sucadded=Data has been successfuly added.
sucupdated=Data has been successfuly updated.
sucdeleted=Data has been successfuly deleted.
captionadd=Insert
captionupdate=Update
captiondelete=Delete
captionconfirm=Confirm
getbeforedlt=Please 'Get' data before trying to delete it.
getbeforeupd=Please 'Get' data before trying to update it.
mustconfirm=Please confirm the data.
confdelete=Confirm deletion.
baddatetime={0} is not a valid date and time.
badtime={0} is not a valid time.
badnum=The value is not a valid number.
nomatch=No matching data was found.
pmterr=Could not find prompt program {0}
refcallerror=Could not find refcall program {0}
browse=Browse
setonlr=Seton Lr
badkeyrfr=Key is not valid now. Refresh pending
dateoutr={0} out of range ({1}-{2}).
arrayerror=Index out of range
callerror=Error calling program
divideerror=Divide by 0
numericalerror=Numerical error
fileerror=File error in file
code=code
index=index
ambiguousck={0} is ambiguous
refinterror=Unknown Referntial Integrity Error
makdsc=Main menu
dbcr1=Data base creation
dbcr2=Table creation
dbcr3=Index Creation
dbcr4=Data transfer
dbcr5=Rename Tables
dbcr6=Model Update
dbcrtitle=GeneXus Database Manager
tblcrea=Creating Tables
idxcrea=Creating Indices
reocom=Reorganization complete
delreo=Deleting reorganization specifications
creinpro="Database creation in progress ...
notcrespc=No creation specifications found
notreospc=There are no reorganization specifications
asktocre=Do you really want to create an empty data base structure?
creok=Database Created
asktoreo=Do you want to reorganize the data base?
reoinpro=Model reorganization in progress ...
okcapt=O&K
genwith=Generated with
aboutcapt=About
sysinfo=&System Info...
notsysinfo=System Information Is Unavailable At This Time
cnclcapt=&Cancel
prtready=Is the printer ready? (Y/N)
rwait=Enter=Continue  Esc=Return
idate=Invalid Date
isdone=Done
nnul=Null values not allowed
discard=Discard modifications
logfull=Transaction Log Is Full, must commit or rollback
opna=Option not Available
savechanges=Do you want to save Changes ?
mnuopts=&File {0} E&xit {1} &Edit {2} Cu&t {3} &Copy {4} &Paste {5} &Delete {6} &Select All {7} &View {8} &Previous {0}0 &Next {0}1 &First {0}2 &Last {0}3 &Toolbar {0}4 &Status Bar {0}5 &Actions {0}6 &Select {0}7 &Refresh {0}8 &Delete Record {0}9 &Window {1}0 &Cascade {1}1 Arrange &Icons {1}2 &Help {1}3 &Contents {1}4 &Search... {1}5 &About {1}6 &Object {1}7 &Expand {1}8 Expand &All
newmnuopts=&File {0} &Close {1} E&xit {2} &Edit {3} Cu&t {4} &Copy {5} &Paste {6} &Delete {7} &Select All {8} &View {0}0 &Previous {0}1 &Next {0}2 &First {0}3 &Last {0}4 &Toolbar {0}5 &Status Bar {0}6 &Actions {0}7 &Select {0}8 &Refresh {0}9 &Delete Record {1}0 &Window {1}1 &Cascade {1}2 Arrange &Icons {1}3 &Help {1}4 &Contents {1}5 &Search... {1}6 &About {1}7 &Confirm
invalid_dir={0} is not a valid directory
gxws_loadingfrom=Loading {0} from
captionaddweb=Add
captionupdateweb=Update
captionconfirmweb=Confirm
captiondeleteweb=Delete
errtitle=Error
err_details=&Details
err_quit=&Quit
err_retry=&Retry
err_login_ldap=Invalid user/password
runtimeerr=Runtime Application Exception
runtimedb=An error ocurred while accessing the database.
runtimeappsrv=An error ocurred while accessing the application server.
colordialog=Select color
dblogin=Server Login
user=User name
password=Password
enteruser=Please type the user name
enterpwd=Please type the password
invaliddate=Invalid date
reportdest=Select destination
reportdest_printer=Printer
reportdest_screen=Screen
reportdest_file=File
button_cancel=&Cancel
button_ok=&Ok
confirmtitle=Confirm
msgtitle=Message
yestext=Yes
notext=No
errconas=Error while connecting to Application Server or Database
gxdbm=GeneXus Database Manager
gxdbm_reorg=GeneXus Database Manager - Reorganization
gxdbm_cpymdl=GeneXus Database Manager - Model Update
confirm_cpymdl=You chose to update the GeneXus model. Are you sure?
gxdbm_gxdb=GeneXus Database Manager - GXDB++ Update
confirmgxdb=You chose to just update the GXDB++. Are you sure?
noreorg=There are no reorganization specifications.
nosuccess=The generation of the reorganization programs wasn't successful. Try again.
confirmreorg=Do you really want to execute the reorganization?
dbnotreorg=The database is not reorganized.
reorgpref=(Reorganize Server Tables preference = No)
reorgsuccess=The reorganization process was successfully completed.
reorgnotsuccess=The reorganization process was not successfully completed.
reorgupdgxdb=Updating GXDB++ ...
reorgrenre=Couldn't rename reorganization flag
reorgrengx=Couldn't rename GXDB++ specification file
reorgerrupdgxdb=Error while trying to update GXDB++ classes
mnufile=&File
mnuexit=E&xit
mnuedit=&Edit
mnucut=Cu&t
mnucopy=&Copy
mnupaste=&Paste
mnudelete=&Delete
mnuselectall=&Select All
mnuview=&View
mnuprev=&Previous
mnunext=&Next
mnufirst=&First
mnulast=&Last
mnutoolbar=&Toolbar
mnustatusbar=&Status Bar
mnuactions=&Actions
mnuselect=&Select
mnurefresh=&Refresh
mnudelrec=&Delete Record
mnuwindow=&Window
mnuarrange=&Tile
mnucascade=&Cascade
mnuhelp=&Help
mnuindex=&Contents
mnusearch=&Search...
mnuabout=&About
mnuclose=&Close
mnuconfirm=&Confirm
toolcut=Cut
toolcopy=Copy
toolpaste=Paste
toolrefresh=Refresh
toolhelp=Help
devmenutrn=Transactions
devmenurpt=Reports
devmenuproc=Procedures
devmenuscr=Work Panels
ids_column=Reorganization Output
ids_execute=&Execute
ids_failed=Reorganization Failed.
ids_ok=Reorganization completed
ids_title=GeneXus Reorganization
ids_close=&Close
ids_noneeded=No Reorganization Needed
ids_needed=Reorganization Needed
ids_run=Running...
january=January
february=February
march=March
april=April
may=May
june=June
july=July
august=August
september=September
october=October
november=November
december=December
vsltlst=Selection list
toolcalculator=Calculator
toolcalendar=Calendar
toolbrowsedata=Browse data
toolselectall=&Select All
tooldelete=&Delete
mnu_previous=&Previous
mnu_tile=&Tile
mnu_contents=Contents
